|#!!!!%!!!!&!!!#!#!!!!&!!!!!!\
|@$$$^$$;$$$$$$$*$$$$$$@$$$$$\
|(№$$$№$$)$$$$$$$$$$$$$+$$$$$\
|$$$$$$$$$$$$$;$$$$$$$+$$$$$$\
|$$$$)$$$$$$)$$$$$;$$$$$$$$$$\
|^$$№$$$$$$$$$$$$$$$$$$$$$$$$\
|$)$$$$$$$$$$$$$)$$$$$$$;$$$$\
|$$$$$$№$$$$$$$№$$$$№$$$$$$$$\
|№$$№$$$$$$$$$$$$$$$$$$$+$$$$\
|$$;$$$$$№$$$$$$$$$$$$$$$$$$$\
|($$$$$$$$№$$$+$$$$$$$$^$$$$$\
|$$$$$$$$$$$$$$$$)$$$$$$$$$$$\
|@$;$$$$$$$$$$$$$$$($$$$$$$$$\
|$$$$$$+$$$$$$$$$;$$$$$$$$$$$\
|$$$$$$$$$$$$$$№$$$$$$+$$$$$$\
|$$$$$$$$$$$$$$@$$$$$$$$$$$$)\
|!!!!!!!!!!!!!!!!!!!!!!!!!!!!\